いかく	異格	名詞
いどうとし	移動都市	名詞
うし	雨師	名詞	将進酒
うじゅう	羽獣	名詞
うんりょうしゅ	雲遼酒	名詞	将進酒
うんれつ	雲裂	名詞
えいし	衛士	名詞
えーしぇんつ	先民	名詞
えんえい	焔影	人名
えんえいりーど	焔影リード	人名
えんえんたるしょくどう	蜿蜒たる蜀道	名詞
えんこく	炎国	地名
えんごく	炎獄	名詞
えんび	焔尾	人名
えんびきし	焔尾騎士	人名
おうてつ	黄鉄	名詞
おうてつのきょうこく	黄鉄の峡谷	地名
おうほうろ	応峰路	名詞	将進酒
おおごと	瑟	名詞
おとがい	顎	名詞	将進酒
おりじにうむ	源石	名詞
おりぱしー	鉱石病	名詞
かい	晦	名詞	画中人の黒いの
かいごう	灰毫	人名
かいごうきし	灰毫騎士	人名
かいふくたて	回復盾	名詞
かいめいそうこく	晦明相克	名詞	画中人
かいめいのいん	晦明の印	名詞	画中人
かいめいのしるし	晦明の印	名詞	画中人
かぎなわし	鉤縄師	名詞
かさねてさけをすすみ	重ねて酒を進み	名詞
がちゅうじん	画中人	名詞	画中人
かんそくし	緩速師	名詞
かんぼう	寒芒	名詞
きこうろうしゅ	帰行老酒	名詞	将進酒
きめい	帰溟	名詞
きゃくさん	客桟	名詞	将進酒
きゅうていしんし	宮廷信使	名詞	将進酒
きょうふうのさげん	狂風の砂原	地名
ぎょうゆう	行裕	名詞	将進酒
きょきさん	居奇山	地名	将進酒
ぎょくもん	玉門	地名
きんてんかん	欽天監	名詞	将進酒
ぎんゆうしゃ	吟遊者	名詞
くろみの	黒簑	名詞
ぐんこう	群攻	名詞
ぐんゆし	群癒師	名詞
けいこう	軽功	名詞	将進酒
けつじょう	血掟	名詞
けつじょうてきさす	血掟テキサス	人名
けんう	剣雨	名詞
げんがん	源岩	名詞
げんがんこう	源岩鉱	名詞
けんじょうほうしゅ	堅城砲手	名詞
げんせき	源石	名詞
こうご	句呉	地名
こうごじょう	句呉城	名詞	将進酒
こうせきびょう	鉱石病	名詞
こうみょうらいらく	光明磊落	名詞	将進酒
こくさい	黒簑	名詞
こしょうしゅ	湖松酒	名詞	将進酒
ごぼうかく	五紡閣	名詞	将進酒
こんたんほう	昏譚峰	地名	将進酒
さが	嵯峨	人名
さげん	砂原	地名
さつこうほう	攥江峰	名詞	将進酒
さんかいしゅう	山海衆	名詞
さんざんじゅうしちほう	三山十七峰	名詞	将進酒
さんざんじゅうはちほう	三山十八峰	名詞	将進酒
しうんほう	梓雲峰	地名	将進酒
しぇん	慎	人名	将進酒
しぇんろう	慎楼	人名	将進酒
しごうきん	熾合金	名詞
しざい	試剤	名詞
しさいだい	司歳台	名詞	将進酒
じしょくにん	持燭人	名詞	将進酒
しほん	四品	名詞	将進酒
しゃさんこじ	煮傘居士	人名	画中人
じゅうじゅん	重盾	名詞
じゅうじゅんえいし	重盾衛士	名詞
じゅうにほん	従二品	名詞	将進酒
しゅくせいいん	粛清院	名詞	将進酒
しゅこうほう	取江峰	地名	将進酒
じゅつせんし	術戦士	名詞
じゅゆし	呪癒師	名詞
しょうき	承曦	人名
しょうぎ	承曦	人名
しょうしょ	尚書	名詞	将進酒
しょうしょく	尚蜀	地名	将進酒
しょくどう	蜀道	名詞
じんかん	人間	名詞	将進酒
しんぎんざん	真銀斬	名詞
じんじつほう	尋日峰	地名	将進酒
しんみん	神民	名詞
しんめい	深溟	名詞
しんらんく	新巒区	地名	将進酒
しんろう	真狼	名詞
すいげき	推撃	名詞
すいげきしゅ	推撃手	名詞
すいばく	睡爆	名詞
すいぼつちょうくつ	水没潮窟	名詞
すうしゅうほう	数舟峰	名詞	将進酒
ずお	左	人名	将進酒
ずおらう	左楽	人名	将進酒
せいどう	錆銅	名詞
せいらいはく	青雷伯	名詞	将進酒
せいらんほう	青鑾峰	地名	将進酒
せきしょう	赤霄	名詞
せんみん	先民	名詞
そうき	操機	名詞
そうこう	崢嶸	名詞	将進酒
そうさんと	争山渡	名詞	将進酒
そうゆう	礎烏有	人名	将進酒
だいじょうふ	大丈夫	名詞	将進酒
たいほー	太合	人名	将進酒
だいりじしょうけい	大理寺少卿	名詞	将進酒
たくじん	濯塵	人名
だくしん	濁心	名詞
たくぢん	濯塵	人名
たんぷ	担夫	名詞	将進酒
ちゃーふう	茶壺	名詞	将進酒
ちんぎんざん	賃金斬	名詞
ちんぎんざん	輝かざる栄光	名詞
てい	鄭	人名	将進酒
ていじゅう	諦獣	名詞
ていちんゆえ	鄭清鉞	名詞	将進酒
でいでいほう	泥泥峰	地名	将進酒
てんがく	天岳	地名	将進酒
てんどう	天瞠	名詞
どぅ	杜	姓	将進酒
とうげん	糖源	名詞
どぅやおいぇ	杜遥夜	人名	将進酒
とうりんい	登臨意	名詞
にん	寧	人名	将進酒
にんつーーちう	寧辞秋	人名	将進酒
ばいでぃんしゃん	白定山	名詞	将進酒
ばんしょうついおくろく	万象追憶録	名詞
ひごえいし	庇護衛士	名詞
ひぼう	牌坊	名詞	将進酒
ひょうきょく	鏢局	名詞	将進酒
ひょうし	鏢師	名詞	将進酒
ひょうとう	鏢頭	名詞	将進酒
ふかい	浮海	名詞
ふくかんさつぎょし	副観察御史	名詞	将進酒
ふへいうし	浮萍雨師	名詞	将進酒
へいすいこう	平祟候	名詞	将進酒
べつりほう	別離峰	地名	将進酒
ぼうすいへい	忘水坪	地名	将進酒
ほうもうかいかい	法網恢恢	名詞	将進酒
ぼくりょう	墨魎	名詞
まおしゅえわん	毛血旺	名詞	将進酒
まなじり	睚	人名
みちょうく	未長区	名詞	将進酒
むそうようらん	夢想揺藍	名詞
めい	明	名詞	画中人の白いの
もうりょう	罔両	名詞	将進酒
もんそうかく	問霜客	名詞	将進酒
やそう	野鬃	名詞
やそうきし	野鬃騎士	名詞
ゆいめん	玉門	地名
ゆうりゅう	遊龍	名詞
ようきし	耀騎士	名詞
らくてい	落蹄	地名
らくていしゅう	落蹄州	地名
りゃん	梁	人名	将進酒
りゃんしゅん	梁洵	人名	将進酒
りゅうある	劉二	人名	将進酒
りゅううんく	流雲区	地名	将進酒
りんちんいぇん	麟青硯	名詞	将進酒
れいぶ	礼部	名詞	将進酒
れいぶさじろう	礼部左侍郎	名詞	将進酒
れんげきし	鎌撃士	名詞
れんさゆし	連鎖癒師	名詞
ろうしゅ	狼主	名詞
ろどす	ロドス	名詞
ろんめん	龍門	地名
ろんめんへい	龍門幣	名詞
わらいておおごとをこせ	笑いて瑟を鼓せ	名詞
ちょんゆえ	重岳	名詞
ぼうあい	芒鞋	名詞	春分
やぞうぼう	治造坊	名詞	春分
えんじゅ	槐	名詞	春分
くんしゃく	勛爵	名詞	ウルサスの子供たち
どうとう	導灯	名詞	導灯の試練
かいこう	恢弘	名詞	導灯の試練
どうとうのしれん	導灯の試練	名詞	導灯の試練
かいこうしれん	恢弘試練	名詞	導灯の試練
していしれん	指定試練	名詞	導灯の試練
ひょうじゅんしれん	標準試練	名詞	導灯の試練
つゆはなむら	露華村	名詞	モンハンコラボ
そうぼさんち	蒼暮山地	名詞	モンハンコラボ
かしわう	柏生	名詞	モンハンコラボ
がいそうじゅう	鎧爪獣	名詞	モンハンコラボ
